NO ./textures/north.png
SO ./textures/south.png
WE ./textures/west.png
EA ./textures/east.png

F 25,200,10
C 50,34,10

11111111111111111111
10000000000000000001
10100000000000000001
10000000000000000001
10000000000000000001
10000000000000000001
10000000000000000001
10000000000000000001
100000000000E0000001
11111111111111111111
