NO ./textures/north_s.png
SO ./textures/south.png
WE ./textures/west.png
EA ./textures/east.png

F 10,10,10
C 0,34,100

111111111
111101111
100000001
1000N0001
100000001
111111111

