NO ./textures/north.png
SO ./textures/south.png
WE ./textures/west.png
EA ./textures/east.png

F 41,90,37
C 66,120,240

111111111111111111
100000000000000001
100000000000000001
100000111111000001
100000100001000001
100000100001000001
100000000000000001
100000000000000001
10000000N000000001
100000000000000001
111111111111111111
