NO ./textures/north.png
SO ./textures/south.png
WE ./textures/west.png
EA ./textures/east.png

F 100,10,0
C 100,10,0

111111111111111111
100000000000000001
100000000000000001
100000111111000001
100000100S01000001
100000100001000001
100000000000000001
100000000000000001
100000000000000001
100000000000000001
111111111111111111
