NO ./textures/north.png
SO ./textures/south.png
WE ./textures/west.png
EA ./textures/east.png

F 15,39,19
C 144,203,228

111111111111111111
100000000000000001
100000000000000001
100000111111000001
100000100S01000001
100000100001000001
100000000000000001
100000000000000001
100000000000000001
100000000000000001
111111111111111111
