NO ./textures/north.png
SO ./textures/south.png
WE ./textures/west.png
EA ./textures/east.png

F 10,10,10
C 0,34,100

111111111111
1011111
10111111
11S
10111111
111111