NO ./textures/north.png
SO ./textures/north.png
WE ./textures/north.png
EA ./textures/north.png
	   
F 40,10,10
C 0,34,100

1111111
1000001
1011101
1010101
1010101
1000001
1011101
101 101
1011101
100N001
1111111