NO ./textures/north.png
SO ./textures/north.png
WE ./textures/north.png
EA ./textures/north.png
	   
F 40,10,10
C 0,34,100


11111
11111
11N11
11111