NO ./textures/north.png

C 220,100,100

SO ./textures/south.png
WE ./textures/west.png
EA ./textures/east.png

F 0,0

111111
110001
100N01
111111